8,2,8,8,8,8,8,8,8,8,8,8,8,8,8,8
8,8,8,8,4,8,8,8,8,4,5,8,8,8,8,8
3,8,8,7,8,8,8,8,8,7,8,8,8,8,8,8
7,8,4,8,8,4,8,8,8,8,8,8,8,4,5,8
8,8,4,8,8,4,7,8,8,8,8,8,8,7,8,8
8,8,4,8,8,4,8,8,8,8,8,8,8,8,8,8
8,8,4,8,8,4,8,8,4,8,8,8,8,8,6,8
8,8,4,8,8,4,8,8,4,7,8,8,8,8,1,1
1,1,1,1,1,1,1,1,1,1,1,1,1,1,1,1
