8,8,8,8,8,8,8,8,8,8,8,8,8,8,8,8
8,8,8,8,8,8,8,8,8,8,8,8,8,8,8,8
8,8,8,2,8,8,8,8,8,8,8,8,8,8,8,8
3,8,4,8,8,8,8,7,8,8,8,8,8,8,8,8
7,8,7,8,8,8,8,8,8,7,8,8,7,8,8,8
8,8,8,8,4,8,8,8,8,8,8,8,8,8,8,8
8,8,8,8,4,4,8,8,8,8,8,4,8,5,6,8
4,4,4,4,4,4,4,4,4,4,4,4,4,4,4,4
1,1,1,1,1,1,1,1,1,1,1,1,1,1,1,1
