8,8,8,8,8,8,8,8,8,8,8,8,8,8,8,8
8,2,8,8,8,8,8,8,8,8,8,8,8,8,8,8
8,8,8,8,8,8,8,8,8,8,8,8,8,8,8,8
8,8,8,8,8,8,8,8,8,8,8,8,8,8,8,8
8,8,8,8,8,8,8,8,8,8,8,8,8,8,8,8
8,3,8,8,8,8,8,8,8,8,8,4,8,8,6,8
1,1,1,1,1,8,1,1,1,1,8,1,1,1,1,1
1,1,1,1,1,1,1,1,1,1,8,1,1,1,1,1
1,1,1,1,1,1,1,1,1,1,1,1,1,1,1,1
